1111111111
1100000011
0000000001
0000000000
1000000000
1000000001
1100000011
1111111111