1111111111
0000000000
0001111000
0100000000
0100000000
1100100100
1100101100
1111111111