1111111111
0000000000
000000ee00
0100001100
0100000000
1100100100
1100101100
1111111111