1111111111
0000000000
0111100000
0111100000
0000000000
0000000110
0000011110
1111111111