1111111111
0000000000
0110000000
0111100000
0000000000
0000000110
00eee11110
1111111111