1111111111
0000000000
0001100000
0001111000
0000000000
1110ee0111
1111111111
1111111111