1111111111
1000000001
1000000001
0000000000
0000000000
1000000001
10@@@@@@01
1111111111