1111111111
0000000000
0000000000
0000000000
0000011000
0011111100
1111111110
1111111111