1111111111
0111111110
0001111000
0000000000
0000000000
0@@0000@@0
1110000111
1111111111