1111111111
1000000001
1000000001
0000000000
000@@@@000
1001111001
10x0000x01
1110000111