1111111111
0000000000
0000000000
0@x0000x@0
1110000111
1100@@0011
1000110001
1000000001