1111111111
0000000000
0000011110
0@@0010000
011@000000
0111000000
0100000000
0000000000