1110000111
1000000001
1000000001
0000xx0000
0000110000
1000000001
100eeee001
1111111111