0000000000
0000110000
0001111000
0000110000
0010000100
0000000000
00e1ee1e00
1111111111