0000000000
0000110000
0001111000
0000110000
0010000100
0000000000
0001001000
1111111111