1100000011
000000x000
00x0001100
0110000000
0111000000
0000000000
00eee01110
1111111111