1100000011
0000000000
0000001100
0111000000
0111000000
0000000000
0000001110
1111111111