1110000111
1000000001
1000000001
0000000000
0000000000
1000000001
10e0000e01
1110000111