1100000011
0000000000
0011001100
0000000000
0000110000
0000000000
0011001100
1000000001