0000000000
0010000000
0111100000
0000000110
0000001100
0000000000
0011000000
1000000001