0000000000
0010e00000
0111100e00
0000000110
0000001100
00e0000000
0011000000
1000000001